11111111111111111111
10000000000000000001
10222222000222222201
10222222000222222231
10000000000000000001
11110111101111101111
11110111101111101111
11110000000000001111
11110111101111101111
10000111101111100001
10220111101111102201
10220000000000002231
10000111101111100001
11110111101111101111
11110111101111101111
13000000000000000001
12222222000222222201
12222222000222222201
13000000000000000031
11111111111111111111